15 10
x x x x x x x x x x
x . o . . . . . . x
x . s . o . . . . x
x . . . . . . . . x
x . s . x . s . . x
x . . . x . . . . x
x . . . . . . . s x
x . . . x x x . . x
x . s . . x o . . x
x . . . . x . . . x
x . . . . . . s . x
x . . . . . . . . x
x . . . o . . . . x
x . . . . . . . . x
x x x x x x x x x x