15 10
x x x x x x x x x x
x . . . . . . . . x
x o s . o . . . . x
x . . o . . . . . x
x s . . x . s . . x
x . . . x . . . . x
x x x . s . . . s x
x . . . s x x . . x
x . s . . x o . . x
x . . . . x . . . x
x . . . . . . s . x
x . o o . . . . . x
x . . o o . . . . x
x . . . . . . . . x
x x x x x x x x x x